10
10
1111111111
1000000001
1010001001
1010000101
1000000001
1010000101
1000000001
1000000001
1000100001
1111111111
5
5
4
2
6
4
6
3
6
5
6
6
4
3
4
5
4
2
4