22
11
6666111116666666666666
6666100016666666666666
6666100016666666666666
6611100011166666666666
6610000000166666666666
1110101110166666111111
1000101110111111100001
1000000000000000000001
1111101111010111100001
6666100000011166111111
6666111111116666666666
8
12
6
5
2
7
3
5
4
8
4
5
7
2
7
19
6
19
7
19
8
20
6
20
7
20
8